3,0,0,0,0,c,0,8,c,c,h,c,0,0,8
0,c,0,0,c,0,c,0,c,c,0,c,c,0,0
0,c,0,0,c,c,c,0,c,0,0,c,0,c,0
0,c,0,0,c,0,c,0,0,c,0,c,c,0,0
0,0,c,c,c,0,0,0,c,c,0,c,c,c,0
0,0,0,0,h,c,c,0,0,0,0,c,h,c,c
0,0,0,0,c,c,0,c,0,c,c,0,0,0,0
0,0,c,0,0,c,c,c,0,c,0,c,0,0,0
0,0,c,0,0,c,0,c,8,c,c,0,0,c,0
0,0,c,0,0,0,0,c,0,c,0,c,c,h,c
0,0,c,c,c,0,0,h,c,0,c,0,0,0,0
0,0,h,c,0,0,0,c,0,0,0,0,0,0,0